###########
..##.#.####
.##..###..#
##........#
#...@..#..#
###..###..#
..#..#....#
.##.##.#.##
.#.........
.#.......##
###########